12 12 12 12 12 12 12 12 12 12 12 12 12 12 12 12 12 12 12 12 12 12 12 12 12 12 12 12 12 12 12 12 12 12 12 12 12 12 12 12 12 12 12 12 12 12 12 12 12 12 
12 12 12 12 12 12 12 12 12 12 12 12 12 12 13 12 12 12 12 12 12 12 12 12 12 12 12 12 12 12 12 12 12 12 12 12 12 12 12 12 12 12 12 12 12 12 12 12 12 12 
12 12 12 12 12 12 12 13 12 12 12 12 12 12 12 12 12 12 12 12 12 12 12 12 12 13 12 12 12 12 12 12 12 13 12 12 12 12 12 12 12 12 12 12 12 12 12 12 12 12 
12 12 12 12 13 12 12 12 12 12 12 13 12 12 12 12 12 12 13 12 12 12 12 12 12 12 12 13 12 12 12 12 12 12 12 12 12 12 12 12 12 13 12 12 12 12 12 12 12 12  
12 12 12 12 12 12 12 12 12 13 12 12 12 12 12 13 12 12 12 12 12 12 12 13 12 12 12 12 12 12 12 13 12 12 13 12 12 12 13 12 12 12 12 12 12 12 12 12 12 12 
12 12 12 12 12 12 12 12 12 12 12 12 12 12 12 12 12 12 12 12 12 13 12 12 12 12 12 12 12 13 12 12 12 12 12 12 13 12 12 12 12 12 12 13 12 12 12 12 12 12  
12 12 12 12 12 12 12 13 40 40 40 40 40 40 40 40 40 40 40 40 40 40 40 40 40 40 40 40 40 40 40 40 40 40 40 40 40 40 40 40 40 12 12 12 12 12 12 12 12 12
12 12 12 12 12 12 12 12 40 41 41 41 41 41 41 41 41 41 41 41 39 39 39 39 39 39 39 39 39 41 39 39 39 35 33 33 33 33 36 41 40 12 12 12 13 12 12 12 12 12
12 12 13 12 12 12 12 12 40 41 41 39 39 39 39 39 39 41 41 41 39 39 39 39 39 39 39 41 41 41 41 41 41 31 26 26 26 26 30 41 40 12 12 12 12 12 12 12 12 12
12 12 12 12 12 12 12 12 40 41 41 39 39 39 39 39 39 41 41 41 39 39 39 39 39 39 39 41 41 41 41 41 41 31 26 26 26 26 30 41 40 12 12 12 12 12 12 12 12 12
12 12 12 13 12 12 12 12 40 41 41 39 39 39 39 39 39 41 41 41 39 39 39 39 39 39 39 41 41 41 41 41 41 31 26 26 26 26 30 41 40 12 13 12 12 12 12 12 12 12
12 12 12 12 13 12 12 12 40 41 41 39 39 39 39 39 39 41 41 41 39 39 39 43 39 39 39 41 41 41 41 41 41 31 26 26 26 26 30 41 40 12 12 12 12 12 12 12 12 12
12 12 12 12 12 12 12 12 40 41 41 41 41 39 39 41 41 41 41 41 39 39 35 33 36 39 39 39 39 39 39 39 39 37 28 28 29 26 30 41 40 12 12 12 12 12 12 12 12 12
12 12 12 12 12 12 12 12 40 41 41 41 39 39 39 39 39 41 41 41 41 41 31 26 30 41 41 41 41 41 41 41 39 41 41 41 31 26 30 41 40 12 13 13 12 12 12 12 12 12
12 12 12 12 13 12 12 12 40 41 41 41 39 39 39 39 39 39 41 41 41 41 31 26 30 41 41 41 41 41 41 41 41 41 41 41 31 26 30 41 40 12 12 12 12 13 12 12 12 12
12 12 12 12 12 12 12 12 40 41 41 41 39 41 39 39 39 39 41 41 41 41 31 26 30 41 41 41 41 41 41 41 41 41 41 41 31 26 30 41 40 12 12 12 12 12 12 12 12 12
12 12 12 12 12 12 12 12 40 41 41 41 39 41 41 39 39 39 39 41 41 41 31 26 30 39 39 39 41 41 41 41 41 41 41 41 31 26 30 41 40 12 12 12 12 12 13 12 12 12
12 12 13 12 12 12 12 12 40 41 41 41 39 41 41 41 41 41 41 41 41 41 31 26 30 41 41 41 41 41 41 41 41 41 35 33 34 26 30 41 40 12 12 13 12 12 12 12 12 12
12 12 12 12 12 12 12 12 40 41 39 39 39 41 41 41 41 41 41 41 41 41 31 26 30 41 41 41 41 41 41 41 41 41 31 26 26 26 30 41 40 12 12 12 12 12 12 12 12 12
12 12 12 13 12 12 12 12 40 41 39 41 41 41 41 41 41 41 41 41 41 39 31 26 30 39 41 41 41 41 41 41 41 41 31 26 26 26 30 41 40 12 13 12 12 12 12 12 12 12
12 12 12 12 12 12 12 12 40 41 39 41 41 39 35 33 33 33 33 33 33 33 34 26 32 33 33 33 33 36 41 41 41 41 31 26 26 26 30 41 40 12 12 12 12 12 12 12 12 12
12 12 12 12 12 13 12 12 40 41 39 41 41 39 31 26 26 26 26 26 26 26 26 26 26 26 26 26 26 30 39 39 39 39 31 26 26 26 30 39 40 12 12 12 12 12 12 12 12 12
12 12 12 12 12 12 13 12 40 41 39 41 41 39 37 28 28 28 28 28 28 28 29 26 27 28 28 28 28 38 41 39 41 41 37 28 29 26 30 39 40 12 13 12 12 12 12 12 12 12
12 12 12 12 12 12 12 12 40 41 39 41 41 39 41 41 41 41 41 41 41 39 31 26 30 39 41 41 41 41 41 39 41 41 41 41 31 26 30 39 40 12 12 12 12 13 12 12 12 12
12 12 12 12 12 12 12 12 40 41 39 41 41 39 41 41 41 41 41 41 41 41 31 26 30 41 41 41 41 41 41 39 41 41 41 41 31 26 30 39 40 12 12 12 12 12 12 12 12 12
12 12 12 12 12 13 12 12 40 41 39 41 41 39 39 39 39 39 41 41 41 41 31 26 30 41 41 41 39 39 39 39 41 41 41 41 31 26 30 39 40 12 12 12 13 12 12 12 12 12
12 12 12 12 12 12 12 12 40 41 39 41 41 41 39 39 39 41 41 41 41 41 31 26 30 41 41 41 41 39 39 41 41 41 41 41 31 26 30 39 40 12 12 12 12 12 12 12 12 12
12 12 12 13 12 12 12 12 40 41 39 41 41 41 39 39 41 39 39 39 41 41 31 26 30 41 41 39 41 39 39 41 41 41 41 41 31 26 30 39 40 12 13 12 12 12 12 12 12 12
12 12 12 12 12 12 12 12 40 41 39 41 41 41 39 39 41 41 41 41 41 41 31 26 30 41 41 41 41 41 39 41 39 41 41 41 31 26 30 39 40 12 12 12 12 12 12 12 12 12
12 12 12 12 12 12 13 12 40 41 39 39 39 39 39 39 39 39 41 41 41 41 31 26 30 41 41 41 41 39 39 41 39 39 41 41 37 28 38 39 40 12 12 12 13 12 12 12 12 12
12 12 12 12 12 12 12 12 40 41 39 39 39 39 39 39 39 39 41 41 41 41 31 26 30 41 41 41 41 41 39 39 39 39 41 41 39 39 39 39 40 12 13 12 12 12 12 12 12 12
12 12 12 12 12 12 12 12 40 41 39 39 39 39 39 39 39 39 41 41 41 41 31 26 30 41 41 41 39 39 39 41 39 41 41 39 39 39 39 39 40 12 12 12 12 12 12 12 12 12
12 12 12 12 12 13 12 12 40 41 39 39 39 39 39 39 39 39 41 41 41 41 31 26 30 41 41 41 41 39 39 41 39 39 41 39 39 39 39 39 40 12 12 12 12 12 13 12 12 12
12 12 12 12 12 12 12 12 40 41 39 39 39 39 39 39 39 39 41 41 41 41 31 26 30 41 41 41 41 39 41 41 39 41 39 39 39 39 39 39 40 13 12 12 12 12 12 12 12 12
12 12 12 12 12 12 12 12 40 41 39 39 39 39 39 39 39 39 41 41 41 41 31 26 30 41 41 41 41 41 41 39 41 39 39 39 39 39 39 39 40 12 12 12 12 12 12 12 12 12
12 12 12 12 13 12 12 12 40 41 41 41 41 41 41 41 41 41 41 41 41 41 37 28 38 41 41 41 41 41 41 41 41 41 41 39 39 39 41 39 40 12 12 12 12 12 12 12 12 12
12 12 12 12 12 12 12 12 40 41 41 41 41 39 39 39 39 39 39 39 39 39 39 39 39 39 39 39 41 41 41 41 41 41 41 39 39 39 39 39 40 12 12 12 13 12 12 12 12 12
12 12 12 12 12 12 13 12 40 41 39 39 39 39 39 39 39 39 41 39 39 39 39 39 39 39 39 39 41 41 39 41 41 39 39 39 39 39 39 39 40 12 12 12 12 12 12 12 12 12
12 12 12 12 12 12 12 12 40 41 41 39 39 39 39 39 39 39 39 39 39 39 39 39 39 39 39 39 41 41 41 41 39 39 39 39 39 39 41 39 40 12 13 12 12 12 12 12 12 12
12 12 12 12 12 12 12 12 40 41 42 41 41 41 41 41 41 41 41 39 39 39 39 39 39 39 39 39 39 41 41 41 39 39 39 39 39 39 39 39 40 12 12 12 12 12 12 12 12 12
12 12 13 12 12 12 12 12 40 41 39 41 41 39 39 39 39 39 39 39 39 39 39 39 39 39 39 39 39 39 39 39 39 39 41 39 39 39 39 39 40 12 12 12 12 13 12 12 12 12
12 12 12 12 12 12 12 12 40 41 39 39 39 39 39 39 39 39 39 39 39 39 39 39 39 39 39 39 39 39 39 39 39 39 39 39 39 39 39 39 40 12 12 12 12 12 12 13 12 12
12 12 12 12 12 12 12 12 40 41 41 41 41 41 39 39 39 39 39 39 39 39 39 39 39 39 39 39 39 39 39 39 39 41 39 39 41 39 39 39 40 12 12 12 12 12 12 12 12 12
12 12 12 12 13 12 12 12 40 40 40 40 40 40 40 40 40 40 40 40 40 40 40 40 40 40 40 40 40 40 40 40 40 40 40 40 40 40 40 40 40 12 13 12 12 12 12 12 12 12
12 12 12 12 12 12 12 12 12 12 12 12 12 12 12 12 12 12 13 12 12 12 12 12 12 12 12 12 12 12 12 12 12 12 12 12 12 12 12 12 12 12 12 12 12 12 13 12 12 12
12 12 12 12 12 12 12 12 12 12 12 13 12 12 12 12 13 12 12 12 12 12 12 12 12 12 12 12 12 12 12 12 12 12 12 12 13 12 12 12 12 12 12 13 12 12 12 12 12 12
12 12 12 12 12 12 13 12 12 12 12 12 12 12 12 12 12 12 12 12 12 12 12 12 13 12 12 12 12 13 12 12 12 12 12 12 12 12 12 12 12 12 12 12 12 12 12 12 12 12
12 12 12 12 12 12 12 12 12 12 12 12 12 12 13 12 12 12 12 12 13 12 12 12 12 12 12 12 12 12 12 12 13 12 12 12 12 12 12 13 12 12 12 12 12 12 12 12 12 12 
12 12 12 12 12 12 12 12 12 12 12 12 12 12 12 12 12 12 12 12 12 12 12 12 12 12 12 13 12 12 12 12 12 12 12 12 12 12 12 12 12 12 12 12 12 13 12 12 12 12 
12 12 12 12 12 12 12 12 12 12 12 12 12 12 12 12 12 12 12 12 12 12 12 12 12 12 12 12 12 12 12 12 12 12 12 12 12 12 12 12 12 12 12 12 12 12 12 12 12 12 