12 12 12 12 12 12 12 12 12 12 12 12 12 12 12 12 12 12 12 12 12 12 12 12 12 12 12 12 12 12 12 12 12 12 12 12 12 12 12 12 12 12 12 12 12 12 12 12 12 12 
12 12 12 12 12 12 12 12 12 12 12 12 12 12 13 12 12 12 12 12 12 12 12 12 12 12 12 12 12 12 12 12 12 12 12 12 12 12 12 12 12 12 12 12 12 12 12 12 12 12 
12 12 12 12 12 12 12 13 12 12 12 12 12 12 12 12 12 12 12 12 12 12 12 12 12 13 12 12 12 12 12 12 12 13 12 12 12 12 12 12 12 12 12 12 12 12 12 12 12 12 
12 12 12 12 13 12 12 12 12 12 12 13 12 12 12 12 12 12 13 12 12 12 12 12 12 12 12 13 12 12 12 12 12 12 12 12 12 12 12 12 12 13 12 12 12 12 12 12 12 12  
12 12 12 12 12 12 12 12 12 13 12 12 12 12 12 13 12 12 12 12 12 12 12 13 12 12 12 12 12 12 12 13 12 12 13 12 12 12 13 12 12 12 12 12 12 12 12 12 12 12 
12 12 12 12 12 12 12 12 12 12 12 12 12 12 12 12 12 12 12 12 12 13 12 12 12 12 12 12 12 13 12 12 12 12 12 12 13 12 12 12 12 12 12 13 12 12 12 12 12 12  
12 12 12 12 12 12 12 13 22 20 20 20 20 20 20 20 20 20 20 20 20 20 20 20 20 20 20 20 20 20 20 20 20 20 20 20 20 20 20 20 23 12 12 12 12 12 12 12 12 12
12 12 12 12 12 12 12 12 18 41 40 40 40 40 40 40 40 40 41 41 10 10 11 10 10 10 10 10 10 41 10 10 10 35 33 33 33 33 36 41 17 12 12 12 13 12 12 12 12 12
12 12 13 12 12 12 12 12 18 41 40 39 39 39 39 39 39 40 41 41 10 10 11 10 10 10 10 41 41 41 41 41 41 31 26 26 26 26 30 41 17 12 12 12 12 12 12 12 12 12
12 12 12 12 12 12 12 12 18 41 40 39 39 39 39 39 39 40 41 41 10 10 11 11 10 10 10 41 41 41 41 41 41 31 26 26 26 26 30 41 17 12 12 12 12 12 12 12 12 12
12 12 12 13 12 12 12 12 18 41 40 39 39 39 39 39 39 40 41 41 10 10 11 10 10 10 11 41 41 41 41 41 41 31 26 26 26 26 30 41 17 12 13 12 12 12 12 12 12 12
12 12 12 12 13 12 12 12 18 41 40 39 39 39 39 39 39 40 41 41 10 11 11 43 10 11 10 41 41 41 41 41 41 31 26 26 26 26 30 41 17 12 12 12 12 12 12 12 12 12
12 12 12 12 12 12 12 12 18 41 40 40 40 39 39 40 40 40 41 41 10 10 35 33 36 10 10 10 10 10 10 10 10 37 28 28 29 26 30 41 17 12 12 12 12 12 12 12 12 12
12 12 12 12 12 12 12 12 18 41 41 41 10 10 10 10 10 41 41 41 41 41 31 26 30 41 41 41 41 41 41 41 10 41 41 41 31 26 30 41 17 12 13 13 12 12 12 12 12 12
12 12 12 12 13 12 12 12 18 41 41 41 10 10 10 10 10 10 41 41 41 41 31 26 30 41 41 41 41 41 41 41 41 41 41 41 31 26 30 41 17 12 12 12 12 13 12 12 12 12
12 12 12 12 12 12 12 12 18 41 41 41 10 41 10 10 10 10 41 41 41 41 31 26 30 41 41 41 41 41 41 41 41 41 41 41 31 26 30 41 17 12 12 12 12 12 12 12 12 12
12 12 12 12 12 12 12 12 18 41 41 41 10 41 41 10 10 10 10 41 41 41 31 26 30 10 10 10 41 41 41 41 41 41 41 41 31 26 30 41 17 12 12 12 12 12 13 12 12 12
12 12 13 12 12 12 12 12 18 41 41 41 10 41 41 41 41 41 41 41 41 41 31 26 30 41 41 41 41 41 41 41 41 41 35 33 34 26 30 41 17 12 12 13 12 12 12 12 12 12
12 12 12 12 12 12 12 12 18 41 10 10 10 41 41 41 41 41 41 41 41 41 31 26 30 41 41 41 41 41 41 41 41 41 31 26 26 26 30 41 17 12 12 12 12 12 12 12 12 12
12 12 12 13 12 12 12 12 18 41 10 41 41 41 41 41 41 41 41 41 41 10 31 26 30 10 41 41 41 41 41 41 41 41 31 26 26 26 30 41 17 12 13 12 12 12 12 12 12 12
12 12 12 12 12 12 12 12 18 41 10 41 41 10 35 33 33 33 33 33 33 33 34 26 32 33 33 33 33 36 41 41 41 41 31 26 26 26 30 41 17 12 12 12 12 12 12 12 12 12
12 12 12 12 12 13 12 12 18 41 10 41 41 11 31 26 26 26 26 26 26 26 26 26 26 26 26 26 26 30 10 10 10 10 31 26 26 26 30 10 17 12 12 12 12 12 12 12 12 12
12 12 12 12 12 12 13 12 18 41 10 41 41 10 37 28 28 28 28 28 28 28 29 26 27 28 28 28 28 38 41 10 41 41 37 28 29 26 30 10 17 12 13 12 12 12 12 12 12 12
12 12 12 12 12 12 12 12 18 41 10 41 41 10 41 41 41 41 41 41 41 10 31 26 30 10 41 41 41 41 41 10 41 41 41 41 31 26 30 10 17 12 12 12 12 13 12 12 12 12
12 12 12 12 12 12 12 12 18 41 10 41 41 10 41 41 41 41 41 41 41 41 31 26 30 41 41 41 41 41 41 10 41 41 41 41 31 26 30 11 17 12 12 12 12 12 12 12 12 12
12 12 12 12 12 13 12 12 18 41 10 41 41 10 10 10 11 11 41 41 41 41 31 26 30 41 41 41 10 10 10 10 41 41 41 41 31 26 30 10 17 12 12 12 13 12 12 12 12 12
12 12 12 12 12 12 12 12 18 41 10 41 41 41 10 10 11 41 41 41 41 41 31 26 30 41 41 41 41 10 10 41 41 41 41 41 31 26 30 10 17 12 12 12 12 12 12 12 12 12
12 12 12 13 12 12 12 12 18 41 10 41 41 41 10 10 41 11 11 11 41 41 31 26 30 41 41 10 41 10 10 41 41 41 41 41 31 26 30 10 17 12 13 12 12 12 12 12 12 12
12 12 12 12 12 12 12 12 18 41 10 41 41 41 10 10 41 41 41 41 41 41 31 26 30 41 41 41 41 41 10 41 10 41 41 41 31 26 30 10 17 12 12 12 12 12 12 12 12 12
12 12 12 12 12 12 13 12 18 41 10 10 10 10 10 10 10 10 41 41 41 41 31 26 30 41 41 41 41 10 10 41 10 10 41 41 37 28 38 10 17 12 12 12 13 12 12 12 12 12
12 12 12 12 12 12 12 12 18 41 11 10 10 10 10 10 10 10 41 41 41 41 31 26 30 41 41 41 41 41 10 10 10 11 41 41 10 10 11 11 17 12 13 12 12 12 12 12 12 12
12 12 12 12 12 12 12 12 18 41 10 10 10 10 10 10 10 10 41 41 41 41 31 26 30 41 41 41 10 11 10 41 11 41 41 10 10 10 10 11 17 12 12 12 12 12 12 12 12 12
12 12 12 12 12 13 12 12 18 41 11 10 10 11 10 10 10 10 41 41 41 41 31 26 30 41 41 41 41 11 11 41 10 11 41 10 10 10 11 10 17 12 12 12 12 12 13 12 12 12
12 12 12 12 12 12 12 12 18 41 11 10 11 10 10 10 10 10 41 41 41 41 31 26 30 41 41 41 41 11 41 41 11 41 11 10 10 11 10 10 17 13 12 12 12 12 12 12 12 12
12 12 12 12 12 12 12 12 18 41 10 10 10 10 10 10 10 10 41 41 41 41 31 26 30 41 41 41 41 41 41 11 41 11 11 10 10 10 11 10 17 12 12 12 12 12 12 12 12 12
12 12 12 12 13 12 12 12 18 41 41 41 41 41 41 41 41 41 41 41 41 41 37 28 38 41 41 41 41 41 41 41 41 41 41 11 10 10 41 11 17 12 12 12 12 12 12 12 12 12
12 12 12 12 12 12 12 12 18 41 41 41 41 10 10 10 10 10 10 10 10 10 10 10 10 10 10 10 41 41 41 41 41 41 41 10 10 10 10 11 17 12 12 12 13 12 12 12 12 12
12 12 12 12 12 12 13 12 18 41 10 10 10 10 10 10 10 10 41 10 10 10 10 10 10 10 10 10 41 41 10 41 41 10 10 10 10 10 10 10 17 12 12 12 12 12 12 12 12 12
12 12 12 12 12 12 12 12 18 41 41 10 10 10 10 10 10 10 10 11 10 10 10 10 10 11 10 10 41 41 41 41 10 10 10 10 10 11 41 10 17 12 13 12 12 12 12 12 12 12
12 12 12 12 12 12 12 12 18 41 42 41 41 41 41 41 41 41 41 10 11 10 10 10 10 10 10 10 10 41 41 41 10 10 10 10 10 11 10 10 17 12 12 12 12 12 12 12 12 12
12 12 13 12 12 12 12 12 18 41 10 41 41 10 10 10 10 10 10 10 10 10 10 10 10 10 10 10 10 10 10 10 10 10 41 10 10 10 10 10 17 12 12 12 12 13 12 12 12 12
12 12 12 12 12 12 12 12 18 41 10 10 10 10 41 14 15 15 16 10 10 10 10 10 11 10 10 14 15 15 16 10 10 10 10 10 10 10 11 10 17 12 12 12 12 12 12 13 12 12
12 12 12 12 12 12 12 12 18 41 41 41 41 41 14 25 12 12 24 16 10 10 10 10 10 10 14 25 12 12 18 10 10 41 10 10 41 10 10 10 17 12 12 12 12 12 12 12 12 12
12 12 12 12 13 12 12 12 24 15 15 15 15 15 25 12 12 12 12 24 15 15 15 15 15 15 25 12 13 12 24 16 10 11 10 10 10 10 14 15 25 12 13 12 12 12 12 12 12 12
12 12 12 12 12 12 12 12 12 12 12 12 12 12 12 12 12 12 13 12 12 12 12 12 12 12 12 12 12 12 12 24 15 15 15 15 15 15 25 12 12 12 12 12 12 12 13 12 12 12
12 12 12 12 12 12 12 12 12 12 12 13 12 12 12 12 13 12 12 12 12 12 12 12 12 12 12 12 12 12 12 12 12 12 12 12 13 12 12 12 12 12 12 13 12 12 12 12 12 12
12 12 12 12 12 12 13 12 12 12 12 12 12 12 12 12 12 12 12 12 12 12 12 12 13 12 12 12 12 13 12 12 12 12 12 12 12 12 12 12 12 12 12 12 12 12 12 12 12 12
12 12 12 12 12 12 12 12 12 12 12 12 12 12 13 12 12 12 12 12 13 12 12 12 12 12 12 12 12 12 12 12 13 12 12 12 12 12 12 13 12 12 12 12 12 12 12 12 12 12 
12 12 12 12 12 12 12 12 12 12 12 12 12 12 12 12 12 12 12 12 12 12 12 12 12 12 12 13 12 12 12 12 12 12 12 12 12 12 12 12 12 12 12 12 12 13 12 12 12 12 
12 12 12 12 12 12 12 12 12 12 12 12 12 12 12 12 12 12 12 12 12 12 12 12 12 12 12 12 12 12 12 12 12 12 12 12 12 12 12 12 12 12 12 12 12 12 12 12 12 12 